2
10 10
.......#..
.......#.#
....#.....
..........
....#.....
..........
........#.
..#.......
..#.#..#..
..........
