A#BBBBBB#C
AD#EE##FFC
A#G##HHHH#
AIGJ##KL#M
#IGJN#KL##
OI#JN#K##P
OIQ#NR##SP
OI#TNR#US#
#IV#N#WUSX
YYYY#ZW#SX
