1
10 10
#.#.#.#...
.##.......
..#....#..
.##.......
....#.#...
.........#
.#.#.#..#.
..##..#..#
...#.#..#.
.......#..
