##AAAA#B##
C####D#BEF
#GGGG#H#EF
#I#J#K###F
LIM##KNNNF
#IM#OK###F
P#MQQQQQQF
######R##F
SS#T#U#VV#
W#XT#UY#Z#
